;
; Level 3 Map
;

; Xsize, Ysize, Zsize

3 3 1

; Roomx Roomy

24 20


; Room 0,0,0
0 0 0
########################
#   #              #   #
# G #              # S #
#   #              #   #
#   #              #   #
#   #              #   #
#   #              #   #
#   ####        ####   #
#   # w            #   #
#                       
#                       
#                       
#   #              #   #
#   #            w #   #
#   ####        ####   #
#   #              #   #
#   #              #   #
# A #              #   #
#   #              #   #
###########   ##########


; Room 1,0,0
1 0 0
########################
#   #              #   #
# G #              # S #
#   #              #   #
#   #              #   #
#   #              #   #
#   #              #   #
#   ####        ####   #
#   # w            #   #
                       
                       
                       
#   #              #   #
#   #            w #   #
#   ####        ####   #
#   #              #   #
#   #              #   #
# A #              #   #
#   #              #   #
###########   ##########


; Room 2,0,0
2 0 0
########################
#   #              #   #
# G #              # S #
#   #              #   #
#   #              #   #
#   #              #   #
#   #              #   #
#   ####        ####   #
#   # w            #   #
                       #
                       #
                       #
#   #              #   #
#   #            w #   #
#   ####        ####   #
#   #              #   #
#   #              #   #
# A #              #   #
#   #              #   #
###########   ##########

; Room 0,1,0
0 1 0
###########   ##########
#   #              #   #
# G #              # S #
#   #              #   #
#   #              #   #
#   #              #   #
#   #              #   #
#   ####        ####   #
#   # w            #   #
#                      
#                       
#                      
#   #              #   #
#   #            w #   #
#   ####        ####   #
#   #              #   #
#   #              #   #
# A #              #   #
#   #              #   #
###########   ##########


; Room 1,1,0
1 1 0
###########   ##########
#   #              #   #
# G #              # S #
#   #              #   #
#   #              #   #
#   #              #   #
#   #              #   #
#   ####        ####   #
#   # w            #   #
                      
                       
                      
#   #              #   #
#   #            w #   #
#   ####        ####   #
#   #              #   #
#   #              #   #
# A #              #   #
#   #              #   #
###########   ##########

; Room 2,1,0
2 1 0
###########   ##########
#   #              #   #
# G #              # S #
#   #              #   #
#   #              #   #
#   #              #   #
#   #              #   #
#   ####        ####   #
#   # w            #   #
                       #
                       #
                       #
#   #              #   #
#   #            w #   #
#   ####        ####   #
#   #              #   #
#   #              #   #
# A #              #   #
#   #              #   #
###########   ##########

; Room 0,2,0
0 2 0
###########   ##########
#   #              #   #
# G #              # S #
#   #              #   #
#   #              #   #
#   #              #   #
#   #              #   #
#   ####        ####   #
#   # w            #   #
#                       
#                      
#                       
#   #              #   #
#   #            w #   #
#   ####        ####   #
#   #              #   #
#   #              #   #
# A #              #   #
#   #              #   #
########################


; Room 1,2,0
1 2 0
###########   ##########
#   #              #   #
# G #              # S #
#   #              #   #
#   #              #   #
#   #              #   #
#   #              #   #
#   ####        ####   #
#   # w            #   #
                        
                        
                        
#   #              #   #
#   #            w #   #
#   ####        ####   #
#   #              #   #
#   #              #   #
# A #              #   #
#   #       T      #   #
###########///##########

; Room 2,2,0
2 2 0
###########   ##########
#   #              #   #
# G #              # S #
#   #              #   #
#   #              #   #
#   #              #   #
#   #              #   #
#   ####        ####   #
#   # w            #   #
                       #
                       #
                       #
#   #              #   #
#   #            w #   #
#   ####        ####   #
#   #              #   #
#   #              #   #
# A #              #   #
#   #              #   #
########################
